/edu/wpi/secrets/resources/images/Tileset.png 5 9
32 24
35 20 22 40 12 12 12 12 12 12 12 12 12 12 12 12 12 12 12 12 12 12 12 12 12 12 12 12 12 12 12 14
35 35 34 10 12 42 22 22 22 22 22 22 40 12 12 12 12 12 12 12 12 12 12 12 12 12 12 12 12 12 42 24
34 34 34 10 12 14 34 34 34 34 34 34 10 12 12 12 12 12 12 12 12 12 12 12 12 12 12 12 12 12 14 34
34 34 34 10 12 14 34 34 34 34 34 34 10 12 12 12 12 12 12 12 12 12 12 12 12 12 12 12 12 12 14 34
34 34 34 10 12 14 34 35 35 34 34 34 10 12 12 12 12 12 42 22 22 22 22 40 12 12 12 12 12 12 14 34
34 34 34 10 12 14 34 34 35 34 34 34 10 12 12 12 12 12 14 34 34 34 34 10 12 12 12 12 12 42 24 35
34 35 34 10 12 14 34 34 34 34 34 34 10 12 12 12 12 12 14 34 34 34 34 20 22 22 40 12 42 24 34 34
34 34 34 10 12 14 34 34 34 34 34 34 10 12 12 12 12 12 14 34 34 35 34 34 34 34 10 12 14 34 35 34
34 34 34 10 12 14 34 34 34 34 34 34 10 12 12 12 12 12 14 35 34 34 34 35 34 34 10 12 14 34 34 34
34 34 34 10 12 14 34 34 34 34 34 34 10 12 12 12 12 12 14 34 34 34 34 34 34 34 10 12 14 34 34 34
34 34 35 10 12 14 34 34 34 35 34 34 10 12 12 12 12 12 14 34 34 34 34 34 34 34 10 12 14 34 34 34
34 34 34 10 12 14 34 34 34 35 34 34 10 12 12 12 12 12 14 34 34 34 34 34 34 34 10 12 14 34 34 34
34 34 34 10 12 14 34 34 34 34 35 34 10 12 12 12 12 12 14 34 34 34 34 34 34 34 10 12 14 34 34 34
34 34 34 10 12 14 34 34 34 34 34 35 10 12 12 12 12 12 14 34 34 34 34 34 34 34 10 12 32  4 34 34
34 34 34 10 12 14 34 34 34 34 34 34 10 12 12 12 12 12 14 34 35 35 34 34 34 34 10 12 12 14 34 34
35 34 34 10 12 14 35 35 34 34 34 34 10 12 12 12 12 12 14 34 35 35 34 34 34 34 10 12 12 14 34 34
34 34 34 10 12 14 34 34 34 34 34 34 10 12 12 12 12 12 14 34 34 35 35 34 34 34 10 12 42 24 35 34
34 34 34 10 12 14 34 34 34 35 34 34 10 12 12 12 12 12 14 34 34 34 34 34 34 34 10 12 14 34 35 35
34 34 34 10 12 32  2  2  2  2  2  2 30 12 12 12 12 12 14 34 34 34 34 34 34 34 10 12 14 34 35 34
34 34 35 10 12 12 12 12 12 12 12 12 12 12 12 12 12 12 14 34 34 34 34 34 34 34 10 12 14 34 35 34
34 34 34 10 12 12 12 12 12 12 12 12 12 12 12 12 12 12 14 34 34 34 35 34 34 34 10 12 14 34 34 34
34 34 34 10 12 12 12 12 12 12 12 12 12 12 12 12 12 12 14 35 34 35 34 35 34 35 10 12 32  4 34 34
34 34 34 10 12 12 12 12 12 12 12 12 12 12 12 12 12 12 32  2  2  2  2  2  2  2 30 12 12 14 34 34
 0  2  2 30 12 12 12 12 12 12 12 12 12 12 12 12 12 12 12 12 12 12 12 12 12 12 12 12 12 14 34 34
