/edu/wpi/secrets/resources/images/CaveTiles.png 5 9
32 24
34 34 39 39 39 34 34 34 34 34 34 39 34 34 34 34 34 39 39 34 34 34 34 34 39 34 39 39 34 34 34 34
34 34 39 39 34 34 34 34 39 34 34 34 34 34 34 39 39 34 34 34 34 39 34 34 34 34 39 34 34 34 34 39
34 34 34 34 34 39 39 34 34 34 34 34 34 34 34 34 34 34 34 39 34 34 34 34 34 39 34 34 34 34 34 39
34 34 39 39 39 34 34 34 34 34 34 39 34 34 34 34 34 34 34 39 39 39 34 34 34 34 34 39 34 34 34 39
34 34 34 39 34 34 34 34 34 34 34 34 34 39 39 34 34 34 39 34 39 39 34 34 34 34 39 34 34 34 34 34
39 39 34 34 34 34 34 34 39 34 34 34 34 34 39 34 34 34 34 39 39 34 34 34 34 34 34 39 34 34 34 39
39 34 34 34 34 39 34 34 34 39 39 34 39 34 34 34 34 34 34 34 34 34 34 34 34 34 39 34 34 34 39 34
34 39 34 34 34 34 34 34 39 39 34 34 34 34 34 34 39 34 34 34 34 39 34 39 34 34 34 34 39 39 34 34
34 34 34 34 34 39 39 34 34 34 34 34 39 34 34 34 34 34 34 34 39 39 34 34 34 34 34 39 34 34 34 34
34 39 34 34 34 34 39 39 34 34 34 34 34 34 34 39 34 34 34 34 34 34 34 39 39 34 34 34 34 34 39 39
34 34 34 34 39 34 34 34 34 34 34 34 34 39 34 39 34 34 39 34 34 34 39 34 34 34 34 34 34 34 34 39
39 34 34 39 34 34 34 34 34 34 39 39 34 34 34 34 34 34 39 34 34 39 39 34 34 34 34 39 34 34 34 34
34 34 34 34 34 34 34 39 34 39 39 34 34 34 34 34 34 34 34 34 34 34 34 34 39 34 34 39 39 39 34 34
17 17 17 17 17 17 17 17 17 17 17 17 17 17 17 17 17 17 17 17 17 17 17 17 17 17 17 17 17 17 17 17
22 22 22 22 22 22 22 22 22 22 22 22 22 22 22 22 22 22 22 22 22 22 22 22 22 22 22 22 22 22 22 22
22 22 22 22 22 22 22 22 22 22 22 22 22 22 22 22 22 22 22 22 22 22 22 22 22 22 22 22 22 22 22 22
22 22 22 22 22 22 22 22 22 22 22 22 22 22 22 22 22 22 22 22 22 22 22 22 22 22 22 22 22 22 22 22
22 22 22 22 22 22 22 22 22 22 22 22 22 22 22 22 22 22 22 22 22 22 22 22 22 22 22 22 22 22 22 22
22 22 22 22 22 22 22 22 22 22 22 22 22 22 22 22 22 22 22 22 22 22 22 22 22 22 22 22 22 22 22 22
22 22 22 22 22 22 22 22 22 22 22 22 22 22 22 22 22 22 22 22 22 22 22 22 22 22 22 22 22 22 22 22
22 22 22 22 22 22 22 22 22 22 22 22 22 22 22 22 22 22 22 22 22 22 22 22 22 22 22 22 22 22 22 22
22 22 22 22 22 22 22 22 22 22 22 22 22 22 22 22 22 22 22 22 22 22 22 22 22 22 22 22 22 22 22 22
22 22 22 22 22 22 22 22 22 22 22 22 22 22 22 22 22 22 22 22 22 22 22 22 22 22 22 22 22 22 22 22
22 22 22 22 22 22 22 22 22 22 22 22 22 22 22 22 22 22 22 22 22 22 22 22 22 22 22 22 22 22 22 22
