/edu/wpi/secrets/resources/images/CaveTiles.png 5 9
32 24
34  5  3 34 34 34 39 39 39 34 34 39 39 34 34 34 39 39 34 34 39 34 34 34 34 34 34 39 34 39 34 39
34  5  3 14  7  7  7  7  7  7  7 13 34 14  7  7  7  7 13 34 34 39 34 39 34 34 34 39 34 34 34 39
34  5  6  8  0  1  1  1  1  1  2  6  7  8  0  1  1  2  6  7 13 34 39 34 34 34 39 34 39 39 34 34
39 11  1  1 10 34 39 34 34 34 11  1  1  1 10 39 39 11  1  2  6  7  7  7  7  7  7  7  7  7 13 34
39 34 34 39 34 34 34 34 34 34 34 34 34 34 34 34 34 34 39 11  1  1  1  1  1  1  1  1  1  2  3 34
34 34 34 39 34 34 34 34 39 39 34 34 34 34 39 34 34 34 39 34 34 34 39 39 34 34 34 34 34  5  3 34
34 34 34 34 39 34 34 34 34 34 39 34 34 34 39 34 34 39 34 12 34 34 34 39 34 39 34 39 34  5  6  7
34 34 34 34 39 39 39 39 39 34 34 39 39 34 39 34 34 34 34 34 34 34 34 39 34 39 34 34 34 11  1  1
39 14 13 34 34 34 34 34 34 39 34 14 13  4 34 34 34 34 34 39 34 34 34 34 34 34 39 34 39 39 34 39
34  5  6  7  7 13 34 34 34 14  7  8  3 39 34 39 34 34 34 34 34 34 34 34 39 34 39 39 39 14  7  7
34  5  0  1  2  6  7  7  7  8  0  8  3 34 34 34 34 34 34 34 39 34 34 14  7 13 39 39 34  5  0  1
14  8  3 34 11  1  1  1  1  1  2  0 10 34 39 34 39 39 34 39 39 39 14  8  0  6  7  7  7  8  3 34
11  2  3 39 39 34 34 34 39 34  5  3 34 34 34 34 34 14  7  7  7  7  8  0  1  1  1  1  1  1 10 39
34  5  3 39 39 34 39 39 34 34  5  3 34 39 34 34 34  5  0  1  1  1  1 10 34 34 34 34 34 39 34 34
39  5  3 34 34 34 39 39 39 34  5  6 13 34 34 39 34  5  3 34 39 39 34 39 34 39 34 34 39 34 34 39
34  5  3 34 34 34 39 34 39 34 11  2  6  7  7  7  7  8  3 39 39 39 34 39 39 39 34 39 34 34 39 34
34  5  3 39 39 34 39 34 34 39 39 11  1  1  1  1  1  1 10 34 39 39 34 39 34 34 39 39 34 39 34 34
34  5  3 34 34 39 39 34 34 39 34 34 34 39 34 34 39 39 34 34 34 39 39 34 34 34 39 39 34 39 34 34
34  5  3 39 39 34 39 39 34 34 34 39 34 39 34 34 34 34 34 34 39 34 34 34 34 34 34 39 39 39 34 39
39  5  3 34 39 34 34 34 39 34 34 34 34 34 34 39 34 34 34 34 34 34 39 39 39 34 39 39 34 34 34 39
39  5  3 34 39 34 34 39 39 34 39 39 34 34 39 34 39 39 34 34 34 34 34 39 39 39 34 34 34 34 39 34
34  5  3 34 39 39 34 34 39 34 34 39 34 39 34 34 34 39 39 34 34 34 34 34 39 39 34 34 34 34 39 34
39  5  3 34 39 34 34 34 39 39 34 34 39 34 34 39 34 34 34 34 34 34 39 39 34 39 34 39 34 39 34 39
34  5  3 39 39 34 34 34 34 34 39 34 34 39 34 34 39 34 34 39 34 39 39 34 34 34 34 34 39 34 34 34
